 width= 10 
 height= 32

1 1 1 1 32 50 1 1 1 1 
1 1 32 32 32 52 32 32 1 1 
1 1 32 32 32 49 32 32 1 1 
1 1 32 32 32 32 32 32 1 1 
1 1 32 32 32 32 52 32 1 1 
1 1 32 32 32 32 51 32 1 1 
1 1 32 32 32 32 32 32 1 1 
1 1 32 32 32 32 53 32 1 1 
1 1 32 32 32 32 32 32 1 1 
1 1 32 32 32 32 32 32 1 1 
1 1 32 32 32 32 32 32 1 1 
1 1 32 32 32 32 52 32 1 1 
1 1 32 32 32 49 32 32 1 1 
1 1 32 32 51 32 32 32 1 1 
1 1 32 32 32 32 52 32 1 1 
1 1 32 32 32 32 51 32 1 1 
1 1 32 32 32 32 32 32 1 1 
1 1 32 32 32 32 49 32 1 1 
1 1 32 32 52 32 32 32 1 1 
1 1 32 32 49 32 32 32 1 1 
1 1 32 52 32 32 32 32 1 1 
1 1 32 32 32 49 32 32 1 1 
1 1 32 32 32 32 32 32 1 1 
1 1 32 32 32 32 49 32 1 1 
1 1 32 32 32 49 32 32 1 1 
1 1 32 32 52 32 32 32 1 1 
1 1 32 32 32 49 32 32 1 1 
1 1 32 32 52 32 32 32 1 1 
1 1 32 32 32 49 32 32 1 1 
1 1 32 32 50 32 32 32 1 1 
1 1 32 32 32 32 32 32 1 1 
27 27 27 27 56 56 27 27 27 27
