width= 10  
height= 12

192 192 192 192 192 192 192 192 192 192 192
192 192 192 192 192 192 192 192 192 192 192
192 192 192 192 192 192 192 192 192 192 192
192 192 192 192 192 192 192 192 192 192 192
192 192 192 192 192 192 181 181 181 181 181
192 192 192 192 192 192 181 192 192 192 192
192 192 192 192 192 192 181 192 192 192 192
192 192 192 192 192 192 181 192 192 192 192
192 192 192 192 192 192 181 192 192 192 192
192 192 192 192 192 192 181 192 192 192 192
192 192 192 192 192 192 181 192 192 192 192
192 192 192 192 192 192 181 181 181 181 181




