width= 10 
height= 32

1 1 5 6 32 32 32 32 1 1 
1 1 32 32 32 32 32 32 1 47 
1 1 32 32 32 32 32 32 1 46 
1 1 32 32 32 32 32 32 1 45 
1 1 32 32 32 32 32 32 1 44 
1 1 32 32 32 32 32 32 1 43 
1 1 32 32 32 32 32 32 1 42 
1 1 32 32 32 32 32 32 1 41 
1 1 32 32 32 32 32 32 1 40 
1 1 32 32 32 32 32 32 1 39 
1 1 32 32 32 32 32 32 1 38 
1 1 32 32 32 32 32 32 1 37 
1 1 32 32 32 32 32 32 1 36 
1 1 32 32 32 32 32 32 1 35
1 1 32 32 32 32 32 32 1 34 
1 1 32 32 32 32 32 32 1 33 
1 1 32 32 32 32 32 32 1 47 
1 1 32 32 32 32 32 32 1 46 
1 1 32 32 32 32 32 32 1 45 
1 1 32 32 32 32 32 32 1 44 
1 1 32 32 32 32 32 32 1 43 
1 1 32 32 32 32 32 32 1 42 
1 1 32 32 32 32 32 32 1 41 
1 1 32 32 32 32 32 32 1 40 
1 1 32 32 32 32 32 32 1 39 
1 1 32 32 32 32 32 32 1 38 
1 1 32 32 32 32 32 32 1 37 
1 1 32 32 32 32 32 32 1 36 
1 1 32 32 32 32 32 32 1 35 
1 1 32 32 32 32 32 32 1 34 
1 1 12 4 32 32 32 32 1 33 
27 27 27 27 32 32 27 27 27 27
