width= 10
height= 32

1 12 6 7 32 32 32 32 32 1 
1 13 32 32 32 32 32 32 32 1 
1 32 32 32 32 32 32 32 32 1 
1 32 32 32 32 32 32 32 32 1 
1 32 32 32 32 32 32 32 32 1 
1 32 32 32 32 32 32 32 32 1 
1 32 32 32 32 32 32 32 32 1 
1 32 32 32 32 32 32 32 32 1 
1 32 32 32 32 32 32 32 32 1 
1 32 32 32 32 32 32 32 32 1 
1 32 32 32 32 32 32 32 32 1 
1 32 32 32 32 32 32 32 32 1 
1 32 32 32 32 32 32 32 32 1 
1 32 32 32 32 32 32 32 32 1 
1 32 32 32 32 32 32 32 32 1 
1 32 32 32 32 32 32 32 32 1 
1 32 32 32 32 32 32 32 32 1 
1 32 32 32 32 32 32 32 32 1 
1 32 32 32 32 32 32 32 32 1 
1 32 32 32 32 32 32 32 32 1 
1 32 32 32 32 32 32 32 32 1 
1 32 32 32 32 32 32 32 32 1 
1 32 32 32 32 32 32 32 32 1 
1 32 32 32 32 32 32 32 32 1 
1 32 32 32 32 32 32 32 32 1 
1 32 32 32 32 32 32 32 32 1 
1 32 32 32 32 32 32 32 32 1 
1 32 32 32 32 32 32 32 32 1 
1 32 32 32 32 32 32 32 32 1 
1 32 32 32 32 32 32 32 32 1 
1 2 3 4 32 32 32 32 32 1 
27 27 27 27 28 28 27 27 27 27
