width= 10 
height= 32

31 1 5 6 32 32 32 32 1 1 
31 1 32 32 32 32 32 32 1 1 
47 1 32 32 32 32 32 32 1 1 
46 1 32 32 32 32 32 32 1 1 
45 1 32 32 32 32 32 32 1 1 
44 1 32 32 32 32 32 32 1 1 
43 1 32 32 32 32 32 32 1 1 
42 1 32 32 32 32 32 32 1 1 
41 1 32 32 32 32 32 32 1 1 
40 1 32 32 32 32 32 32 1 1 
39 1 32 32 32 32 32 32 1 1 
38 1 32 32 32 32 32 32 1 1 
37 1 32 32 32 32 32 32 1 1 
36 1 32 32 32 32 32 32 1 1 
35 1 32 32 32 32 32 32 1 1 
34 1 32 32 32 32 32 32 1 1 
33 1 32 32 32 32 32 32 1 1 
47 1 32 32 32 32 32 32 1 1 
46 1 32 32 32 32 32 32 1 1 
45 1 32 32 32 32 32 32 1 1 
44 1 32 32 32 32 32 32 1 1 
43 1 32 32 32 32 32 32 1 1 
42 1 32 32 32 32 32 32 1 1 
41 1 32 32 32 32 32 32 1 1 
40 1 32 32 32 32 32 32 1 1 
39 1 32 32 32 32 32 32 1 1 
38 1 32 32 32 32 32 32 1 1 
37 1 32 32 32 32 32 32 1 1 
36 1 32 32 32 32 32 32 1 1 
35 1 32 32 32 32 32 32 1 1 
34 1 10 3 32 32 32 32 1 1 
27 27 27 27 28 28 27 27 27 27
