width= 10 
height= 32

1 1 5 6 32 32 32 32 1 1 
1 1 32 32 32 32 32 32 1 1 
1 1 32 32 32 32 32 32 1 1 
1 1 32 32 32 32 32 32 1 1 
1 1 32 32 32 32 32 32 1 1 
1 1 32 32 32 32 32 32 1 1 
1 1 32 32 32 32 32 32 1 1 
1 1 32 32 32 32 32 32 1 1 
1 1 32 32 32 32 32 32 1 1 
1 1 32 32 32 32 32 32 1 1 
1 1 32 32 32 32 32 32 1 1 
1 1 32 32 32 32 32 32 1 1 
1 1 32 32 32 32 32 32 1 1 
1 1 32 32 32 32 32 32 1 1 
1 1 32 32 32 32 32 32 1 1 
1 1 32 32 32 32 32 32 1 1 
1 1 32 32 32 32 32 32 1 1 
1 1 32 32 32 32 32 32 1 1 
1 1 32 32 32 32 32 32 1 1 
1 1 32 32 32 32 32 32 1 1 
1 1 32 32 32 32 32 32 1 1 
1 1 32 32 32 32 32 32 1 1 
1 1 32 32 32 32 32 32 1 1 
1 1 32 32 32 32 32 32 1 1 
1 1 32 32 32 32 32 32 1 1 
1 1 32 32 32 32 32 32 1 1 
1 1 32 32 32 32 32 32 1 1 
1 1 32 32 32 32 32 32 1 1 
1 1 32 32 32 32 32 32 1 1 
1 1 32 32 32 32 32 32 1 1 
1 1 10 3 32 32 32 32 1 1 
27 27 27 27 28 28 27 27 27 27
